####################
#........#.........#
#........+.........#
#........#.........#
#........#.........#
####################